Ticker,Avg_Sentiment,Count_Positive,Count_Negative,Count_Neutral,Total_Headlines
LLY,0.05,18,14,31,63
RTX,0.16,19,3,25,47
TSLA,0.04,8,6,20,34
GOOGL,0.19,10,3,6,19
NVDA,0.2,8,0,10,18
PFE,0.09,5,2,10,17
SRAD,0.11,6,0,11,17
MRVL,0.22,8,1,5,14
ADI,0.11,2,0,6,8
UUUU,0.28,5,1,1,7
