Ticker,Avg_Sentiment,Count_Positive,Count_Negative,Count_Neutral,Total_Headlines
LLY,0.05,18,14,31,63
MSFT,0.11,15,5,31,51
AAPL,0.03,12,10,24,46
PLTR,0.01,3,4,26,33
RTX,0.11,10,3,20,33
TSLA,0.03,7,6,18,31
GOOGL,0.17,9,3,7,19
PFE,0.11,6,2,11,19
SRAD,0.11,6,0,11,17
NVDA,0.17,6,0,10,16
