Ticker,Avg_Sentiment,Count_Positive,Count_Negative,Count_Neutral,Total_Headlines
LLY,0.05,18,14,31,63
MSFT,0.11,15,5,31,51
RTX,0.16,19,3,25,47
AAPL,0.03,12,10,23,45
PLTR,0.01,3,4,26,33
TSLA,0.04,8,6,18,32
GOOGL,0.17,9,3,7,19
PFE,0.09,5,2,10,17
SRAD,0.11,6,0,11,17
NVDA,0.17,6,0,10,16
