Ticker,Avg_Sentiment,Count_Positive,Count_Negative,Count_Neutral,Total_Headlines
LLY,0.07,19,11,30,60
RTX,0.13,15,3,18,36
NVDA,0.2,14,1,10,25
TSLA,0.01,5,4,13,22
GOOGL,-0.01,6,6,9,21
MRVL,0.24,7,0,6,13
SRAD,0.17,5,0,7,12
PFE,-0.04,1,2,5,8
UUUU,0.37,6,0,1,7
ADI,0.18,3,0,3,6
